1111111111111111
1000000000000001
1000020000000022
1222222200000002
1212121212121212
1222222222222222
1111111111111111
1111111111111111
1111111111111112
1221200000000000
1000121201201020
1111111111111111